1111111111111111111
10C000010000C000001
1010000000000C00001
101000000100EC01001
10C0C00C0111C000001
100000000C000010001
1000CC0001000000001
101010000C100100001
100001000C000011001
1000000000101001
1001001000000000101
1010000000000000001
10000P0110000010001
1111111111111111111
