11111111111111111111111111111111
1E000000000000C00000C00000000001
10101010010000010100100000001011
10101001010101000100100000001011
1P000000C00C000000000000000000C1
11111111111111111111111111111111
